TTTTTTTTTTT
TOOOOOOOOOT
TO       OT
TO       OT
TO  OOO  OT
TO    O. OT
TO     O OT
TO  B  O OT
TO     O OT
TOOOOOOOOOT
TTTTTTTTTTT