TTTTTTTTTTT
TOOOOOOOOTT
TO   O  OTT
TO  BR  OTT
TO   OB OTT
TOOOOO SOTT
TTTTTO SOTT
TTTTTOOOOTT
TTTTTTTTTTT