TTTTTTTTT
TTOOOOTTT
TTO  OTTT
TTO  OOOT
TTO *  OT
TOOBOB OT
TO SRS OT
TO    OOT
TOOO  OTT
TTTOOOOTT
TTTTTTTTT