TTTTTTTTT
TOOOOOOOT
TOS O ROT
TO  OB OT
TOS  B OT
TO  OB OT
TOS O  OT
TOOOOOOOT
TTTTTTTTT