TTTTTTTTTT
TOOOOOOTTT
TOSSS OOOT
TO S B  OT
TO  BBB OT
TOOOO  ROT
TTTTOOOOOT
TTTTTTTTTT