TTTTTTTTTTT
TTTOOOOOOTT
TOOOSO  OTT
TO    B OOT
TO B R  SOT
TOOO O OOOT
TTTOBO OTTT
TTTO  SOTTT
TTTOOOOOTTT
TTTTTTTTTTT