TTTTTTTT
TOOOOOOT
TO    OT
TO OR OT
TO SB OT
TO    OT
TOOOOOOT
TTTTTTTT