TTTTTTTTTT
TOOOOOOOOT
TO   O  OT
TO  BR  OT
TO   OB OT
TOOOOO SOT
TTTTTO SOT
TTTTTOOOOT
TTTTTTTTTTT